alias gs='git status'
alias go='git checkout'
alias gg='git pull'
alias ga='git add . --all'
alias gc='git commit -m'
alias gp='git push'
alias gu='git push -u'
alias gb='git checkout -b'
alias gm='git merge'
alias gr='git reset .'
alias gh='git reset HEAD --hard'
alias gd='git diff'


alias np='npm publish'
alias op='open publish'


_v() {
    npm --no-git-tag-version version ${1:-patch}
}
alias v=_v

alias b='npm run --silent build-debug'
alias w='npm run --silent watch-debug'

alias i='npm install'

alias s='npm start'

alias t='npm test'

alias r='rm -rf'

alias p='propagate'

alias m='./make.sh'
alias d='./deploy.sh'
alias s='./standup.sh'

alias k='ssh-keygen -t rsa -b 4096'

alias l='ls -l'
alias m='./make.sh'
alias c='clear'
alias x='exit'

alias e='nano .personalrc'
alias a='source .personalrc'


alias h='cd ~'
